%%%%%%%%%%%%%%%%%%%%%%%%%%%%%%%%%%%%%%%%%%%%%%%%%%%%%%%%%%%%%%%%%%%%%%%%%
%       % % %           %   %     % %       % % %           %   %     % %
% %%%%%%% % %%% % %%% %%% %%%%%%% % % %%%%%%% % %%% % %%% %%% %%%%%%% % %
%       %       % %     %     % %   %       %       % %     %     % %   %
%%%%% %%%%% %%% % % % %%% %%%%% % %%%%%%% %%%%% %%% % % % %%% %%%%% % %%%
%   % % % %   % % % %   % %   % %   %   % % % %   % % % %   % %   % %   %
% %%% % % % %%% %%%%% %%% % %%% %%% % %%% % % % %%% %%%%% %%% % %%% %%% %
%       %     %   %   %     % % %   %       %     %   %   %     % % %   %
%%% %%%%%%%%% %%%%%%% %%% %%% % % % %%% %%%%%%%%% %%%%%%% %%% %%% % % % %
%             %       % %   %     % %             %       % %   %     % %
% % %%%%% % %%% % % %%% % %%% %%% % % % %%%%% % %%% % % %%% % %%% %%% % %
% % %     % % % % %     %   % % % % % % %     % % % % %     %   % % % % %
% % % %%%%%%% % %%%%%%%%% %%% % %%% % % % %%%%%%% % %%%%%%%%% %%% % %%% %
% % % %     %   %     %     %   %   % % % %     %   %     %     %   %   %
%%% %%% % %%%%% %%%%% %%% %%% %%%%% %%% %%% % %%%%% %%%%% %%% %%% %%%%% %
%     % % %     % %     % %   % % % %     % % %     % %     % %   % % % %
% % % % % %%% %%% %%% %%% % % % % % % % % % % %%% %%% %%% %%% % % % % % %
% % % % %                 % % %     % % % % %                 % % %     %
%%% %%%%%%% % % %%%%% %%% % %%% %%%%%%% %%%%%%% % % %%%%% %%% % %%% %%%%%
%       % % % %     %   %     % %   %       % % % %     %   %     % %   %
%%%%% % % %%%%%%%%% %%%%%%%%%%% % %%%%%%% % % %%%%%%%%% %%%%%%%%%%% % %%%
%   % %           % %     %   % %   %   % %           % %     %   % %   %
% %%% %%%%% %%%%%%%%% %%%%% % % %%% % %%% %%%%% %%%%%%%%% %%%%% % % %%% %
% %   %      %        %     %       % %   %      %        %     %       %
% % % %%%%% %%% % % % % %%%%%%%%%%%%% % % %%%%% %%% % % % % %%%%%%%%%%%%%
% % %   %     % % % %       %   % % % % %   %     % % % %       %   % % %
% % %%% %%% % % % %%%%%%%%% %%% % % % % %%% %%% % % % %%%%%%%%% %%% % % %
% %   % %   % % %   % %   % % %     % %   % %   % % %   % %   % % %     %
% %%% %%% %%%%% %%% % % %%%%% % %%%%% %%% %%% %%%%% %%% % % %%%%% % %%%%%
%       %   %     % %     %   % %   %       %   %     % %     %   % %   %
%%% % %%%%% %%%%% %%% %%% % %%% % %%%%% % %%%%% %%%%% %%% %%% % %%% % %%%
% % % % % % % %     % %   % %   % % % % % % % % % %     % %   % %   % % %
% % %%% % % % % %%%%%%%%% % % % % % % % %%% % % % % %%%%%%%%% % % % % % %
%   %   %   %                 %     %   %   %   %                 %     %
% % % % %%% %%% %%%%%%% %%% %%% %%% % % % % %%% %%% %%%%%%% %%% %%% %%% %
%P% % %       %   %       %   % %     % % %       %   %       %   % %   %
%%%%%%%%%%%%%%%%%%%%%%%%%%%%%%%%%%%%%%%%%%%%%%%%%%%%%%%%%%%%%%%%%%%%%%% %
%       % % %           %   %     % %       % % %           %   %     % %
% %%%%%%% % %%% % %%% %%% %%%%%%% % % %%%%%%% % %%% % %%% %%% %%%%%%% % %
%       %       % %     %     % %   %       %       % %     %     % %   %
%%%%% %%%%% %%% % % % %%% %%%%% % %%%%%%% %%%%% %%% % % % %%% %%%%% % %%%
%   % % % %   % % % %   % %   % %   %   % % % %   % % % %   % %   % %   %
% %%% % % % %%% %%%%% %%% % %%% %%% % %%% % % % %%% %%%%% %%% % %%% %%% %
%       %     %   %   %     % % %   %       %     %   %   %     % % %   %
%%% %%%%%%%%% %%%%%%% %%% %%% % % % %%% %%%%%%%%% %%%%%%% %%% %%% % % % %
%             %       % %   %     % %             %       % %   %     % %
% % %%%%% % %%% % % %%% % %%% %%% % % % %%%%% % %%% % % %%% % %%% %%% % %
% % %     % % % % %     %   % % % % % % %     % % % % %     %   % % % % %
% % % %%%%%%% % %%%%%%%%% %%% % %%% % % % %%%%%%% % %%%%%%%%% %%% % %%% %
% % % %     %   %     %     %   %   % % % %     %   %     %     %   %   %
%%% %%% % %%%%% %%%%% %%% %%% %%%%% %%% %%% % %%%%% %%%%% %%% %%% %%%%% %
%     % % %     % %     % %   % % % %     % % %     % %     % %   % % % %
% % % % % %%% %%% %%% %%% % % % % % % % % % % %%% %%% %%% %%% % % % % % %
% % % % %                 % % %     % % % % %                 % % %     %
%%% %%%%%%% % % %%%%% %%% % %%% %%%%%%% %%%%%%% % % %%%%% %%% % %%% %%%%%
%       % % % %     %   %     % %   %       % % % %     %   %     % %   %
%%%%% % % %%%%%%%%% %%%%%%%%%%% % %%%%%%% % % %%%%%%%%% %%%%%%%%%%% % %%%
%   % %           % %     %   % %   %   % %           % %     %   % %   %
% %%% %%%%% %%%%%%%%% %%%%% % % %%% % %%% %%%%% %%%%%%%%% %%%%% % % %%% %
% %   %      %        %     %       % %   %      %        %     %       %
% % % %%%%% %%% % % % % %%%%%%%%%%%%% % % %%%%% %%% % % % % %%%%%%%%%%%%%
% % %   %     % % % %       %   % % % % %   %     % % % %       %   % % %
% % %%% %%% % % % %%%%%%%%% %%% % % % % %%% %%% % % % %%%%%%%%% %%% % % %
% %   % %   % % %   % %   % % %     % %   % %   % % %   % %   % % %     %
% %%% %%% %%%%% %%% % % %%%%% % %%%%% %%% %%% %%%%% %%% % % %%%%% % %%%%%
%       %   %     % %     %   % %   %       %   %     % %     %   % %   %
%%% % %%%%% %%%%% %%% %%% % %%% % %%%%% % %%%%% %%%%% %%% %%% % %%% % %%%
% % % % % % % %     % %   % %   % % % % % % % % % %     % %   % %   % % %
% % %%% % % % % %%%%%%%%% % % % % % % % %%% % % % % %%%%%%%%% % % % % % %
%   %   %   %                 %     %   %   %   %                 %     %
% % % % %%% %%% %%%%%%% %%% %%% %%% % % % % %%% %%% %%%%%%% %%% %%% %%% %
% % % %       %   %       %   % %     % % %       %   %       %   % %   %
% %%%%%%%%%%%%%%%%%%%%%%%%%%%%%%%%%%%%%%%%%%%%%%%%%%%%%%%%%%%%%%%%%%%%%%%
%       % % %           %   %     % %       % % %           %   %     % %
% %%%%%%% % %%% % %%% %%% %%%%%%% % % %%%%%%% % %%% % %%% %%% %%%%%%% % %
%       %       % %     %     % %   %       %       % %     %     % %   %
%%%%% %%%%% %%% % % % %%% %%%%% % %%%%%%% %%%%% %%% % % % %%% %%%%% % %%%
%   % % % %   % % % %   % %   % %   %   % % % %   % % % %   % %   % %   %
% %%% % % % %%% %%%%% %%% % %%% %%% % %%% % % % %%% %%%%% %%% % %%% %%% %
%       %     %   %   %     % % %   %       %     %   %   %     % % %   %
%%% %%%%%%%%% %%%%%%% %%% %%% % % % %%% %%%%%%%%% %%%%%%% %%% %%% % % % %
%             %       % %   %     % %             %       % %   %     % %
% % %%%%% % %%% % % %%% % %%% %%% % % % %%%%% % %%% % % %%% % %%% %%% % %
% % %     % % % % %     %   % % % % % % %     % % % % %     %   % % % % %
% % % %%%%%%% % %%%%%%%%% %%% % %%% % % % %%%%%%% % %%%%%%%%% %%% % %%% %
% % % %     %   %     %     %   %   % % % %     %   %     %     %   %   %
%%% %%% % %%%%% %%%%% %%% %%% %%%%% %%% %%% % %%%%% %%%%% %%% %%% %%%%% %
%     % % %     % %     % %   % % % %     % % %     % %     % %   % % % %
% % % % % %%% %%% %%% %%% % % % % % % % % % % %%% %%% %%% %%% % % % % % %
% % % % %                 % % %     % % % % %                 % % %     %
%%% %%%%%%% % % %%%%% %%% % %%% %%%%%%% %%%%%%% % % %%%%% %%% % %%% %%%%%
%       % % % %     %   %     % %   %       % % % %     %   %     % %   %
%%%%% % % %%%%%%%%% %%%%%%%%%%% % %%%%%%% % % %%%%%%%%% %%%%%%%%%%% % %%%
%   % %           % %     %   % %   %   % %           % %     %   % %   %
% %%% %%%%% %%%%%%%%% %%%%% % % %%% % %%% %%%%% %%%%%%%%% %%%%% % % %%% %
% %   %      %        %     %       % %   %      %        %     %       %
% % % %%%%% %%% % % % % %%%%%%%%%%%%% % % %%%%% %%% % % % % %%%%%%%%%%%%%
% % %   %     % % % %       %   % % % % %   %     % % % %       %   % % %
% % %%% %%% % % % %%%%%%%%% %%% % % % % %%% %%% % % % %%%%%%%%% %%% % % %
% %   % %   % % %   % %   % % %     % %   % %   % % %   % %   % % %     %
% %%% %%% %%%%% %%% % % %%%%% % %%%%% %%% %%% %%%%% %%% % % %%%%% % %%%%%
%       %   %     % %     %   % %   %       %   %     % %     %   % %   %
%%% % %%%%% %%%%% %%% %%% % %%% % %%%%% % %%%%% %%%%% %%% %%% % %%% % %%%
% % % % % % % %     % %   % %   % % % % % % % % % %     % %   % %   % % %
% % %%% % % % % %%%%%%%%% % % % % % % % %%% % % % % %%%%%%%%% % % % % % %
%   %   %   %                 %     %   %   %   %                 %     %
% % % % %%% %%% %%%%%%% %%% %%% %%% % % % % %%% %%% %%%%%%% %%% %%% %%% %
% % % %       %   %       %   % %     % % %       %   %       %   % %   %
%%%%%%%%%%%%%%%%%%%%%%%%%%%%%%%%%%%%%%%%%%%%%%%%%%%%%%%%%%%%%%%%%%%%%%% %
%       % % %           %   %     % %       % % %           %   %     % %
% %%%%%%% % %%% % %%% %%% %%%%%%% % % %%%%%%% % %%% % %%% %%% %%%%%%% % %
%       %       % %     %     % %   %       %       % %     %     % %   %
%%%%% %%%%% %%% % % % %%% %%%%% % %%%%%%% %%%%% %%% % % % %%% %%%%% % %%%
%   % % % %   % % % %   % %   % %   %   % % % %   % % % %   % %   % %   %
% %%% % % % %%% %%%%% %%% % %%% %%% % %%% % % % %%% %%%%% %%% % %%% %%% %
%       %     %   %   %     % % %   %       %     %   %   %     % % %   %
%%% %%%%%%%%% %%%%%%% %%% %%% % % % %%% %%%%%%%%% %%%%%%% %%% %%% % % % %
%             %       % %   %     % %             %       % %   %     % %
% % %%%%% % %%% % % %%% % %%% %%% % % % %%%%% % %%% % % %%% % %%% %%% % %
% % %     % % % % %     %   % % % % % % %     % % % % %     %   % % % % %
% % % %%%%%%% % %%%%%%%%% %%% % %%% % % % %%%%%%% % %%%%%%%%% %%% % %%% %
% % % %     %   %     %     %   %   % % % %     %   %     %     %   %   %
%%% %%% % %%%%% %%%%% %%% %%% %%%%% %%% %%% % %%%%% %%%%% %%% %%% %%%%% %
%     % % %     % %     % %   % % % %     % % %     % %     % %   % % % %
% % % % % %%% %%% %%% %%% % % % % % % % % % % %%% %%% %%% %%% % % % % % %
% % % % %                 % % %     % % % % %                 % % %     %
%%% %%%%%%% % % %%%%% %%% % %%% %%%%%%% %%%%%%% % % %%%%% %%% % %%% %%%%%
%       % % % %     %   %     % %   %       % % % %     %   %     % %   %
%%%%% % % %%%%%%%%% %%%%%%%%%%% % %%%%%%% % % %%%%%%%%% %%%%%%%%%%% % %%%
%   % %           % %     %   % %   %   % %           % %     %   % %   %
% %%% %%%%% %%%%%%%%% %%%%% % % %%% % %%% %%%%% %%%%%%%%% %%%%% % % %%% %
% %   %      %        %     %       % %   %      %        %     %       %
% % % %%%%% %%% % % % % %%%%%%%%%%%%% % % %%%%% %%% % % % % %%%%%%%%%%%%%
% % %   %     % % % %       %   % % % % %   %     % % % %       %   % % %
% % %%% %%% % % % %%%%%%%%% %%% % % % % %%% %%% % % % %%%%%%%%% %%% % % %
% %   % %   % % %   % %   % % %     % %   % %   % % %   % %   % % %     %
% %%% %%% %%%%% %%% % % %%%%% % %%%%% %%% %%% %%%%% %%% % % %%%%% % %%%%%
%       %   %     % %     %   % %   %       %   %     % %     %   % %   %
%%% % %%%%% %%%%% %%% %%% % %%% % %%%%% % %%%%% %%%%% %%% %%% % %%% % %%%
% % % % % % % %     % %   % %   % % % % % % % % % %     % %   % %   % % %
% % %%% % % % % %%%%%%%%% % % % % % % % %%% % % % % %%%%%%%%% % % % % % %
%   %   %   %                 %     %   %   %   %                 %     %
% % % % %%% %%% %%%%%%% %%% %%% %%% % % % % %%% %%% %%%%%%% %%% %%% %%% %
%.% % %       %   %       %   % %     % % %       %   %       %   % %   %
%%%%%%%%%%%%%%%%%%%%%%%%%%%%%%%%%%%%%%%%%%%%%%%%%%%%%%%%%%%%%%%%%%%%%%%%%
