%%%%%%%%%%%%%%%%%%%%%%%%%%%%%%%%%%%%%%%%%%%%%%%%%%%%%%%%%%%%%%%%%%%%%%%%%%
%                                                                        %
% %%%%%%%%%%%%%%%%%%%%%%%%%%%%%%%%%%%%%%%%%%%%%%%%%%%%%%%%%%%%%%%%%%%%%% %
% %                                                                    %P%
% %                                                                    % %
% %                                                                    % %
% %                                                                    % %
% %                                                                    % %
% %                                                                    % %
% %                                                                    % %
% %                                                                    % %
% %                                                                    % %
% %                                                                    % %
% %                                                                    % %
% %                                                                    % %
% %                                                                    % %
% %                                                                    % %
% %                                                                    % %
% %                                                                    % %
% %                                                                    % %
% %                                                                    % %
% %                                                                    % %
% %                                                                    % %
% %                                                                    % %
% %                                                                    % %
% %                                                                    % %
% %                                                                    % %
% %                                                                    % %
% %%%%%%%%%%%%%%%%%%%%%%%%%%%%%%%%%%%%%%%%%%%%%%%%%%%%%%%%%%%%%%%%%%%%%% %
%.%                                                                      %
%%%%%%%%%%%%%%%%%%%%%%%%%%%%%%%%%%%%%%%%%%%%%%%%%%%%%%%%%%%%%%%%%%%%%%%%%%
