%%%%%%%%%%%%%%%%%%%%%%%%%%%%%%%%%%%%%%%%%%%%%%%%%%%%%%%%%%%
%  %%%% %%%%%%%%%% %%%%%%%%%%%%% %%%%%%%%%%%%%% %%%%%%%%%%%
% %                          P                            %
%  %%%% %%%%%%%%%% %%%%%%%%%%%%% %%%%%%%%%%%%%% %%%%%%%%%%%
%     % %        % %           % %            % %         %
%     % %        % %           % %            % %         %
%     % %        % %           % %            % %         %
%     %%%        %%%           %%%            % %         %
%     % %        % %           % %            % %         %
%  %%%% %%%%%%%%%% %%%%%%%%%%%%% %%%%%%%%%%%%%% %%%%%%%%%%%
% %                                                       %
%  %%%% %%%%%%%%%% %%%%%%%%%%%%% %%%%%%%%%%%%%% %%%%%%%%%%%
%     % %        % %           % %            % %         %
%     % %        % %           % %            % %         %
%     % %        % %           % %            % %         %
%     %%%        % %           %%%            %%%         %
%     % %        % %           % %            % %         %
%  %%%% %%%%%%%%%% %%%%%%%%%%%%% %%%%%%%%%%%%%% %%%%%%%%%%%
% %         %            %                                %
%  %%%% %%%%%%%%%% %%%%%%%%%%%%% %%%%%%%%%%%%%% %%%%%%%%%%%
%     % %        % %           % %            % %         %
%     % %        % %           % %            % %         %
%     % %        % %           % %            % %         %
%     %%%        % %           % %            % %         %
%     % %        % %           % %            % %         %
%  %%%% %%%%%%%%%% %%%%%%%%%%%%% %%%%%%%%%%%%%% %%%%%%%%%%%
%  %                                  %                   %
%  %%%% %%%%%%%%%% %%%%%%%%%%%%% %%%%%%%%%%%%%% %%%%%%%%%%%
%     % %        % %           % %            % %         %
%     % %        % %           % %            % %         %
%     % %        % %           % %            % %         %
%     %%%        %%%           %%%            % %         %
%     % %        % %           % %            % %         %
%  %%%% %%%%%%%%%% %%%%%%%%%%%%% %%%%%%%%%%%%%% %%%%%%%%%%%
%  %        %            %                                %
%  %%%% %%%%%%%%%% %%%%%%%%%%%%% %%%%%%%%%%%%%% %%%%%%%%% %
%     % %        % %           % %            % %         %
%     % %        % %           % %            % %         %
%     % %        % %           % %            % %         %
%%%%%%%%%%%%%%%%%%%%%%%%%%%%%%%%%%%%%%%%%%%%%%%%%         %
%.                                                        %
%%%%%%%%%%%%%%%%%%%%%%%%%%%%%%%%%%%%%%%%%%%%%%%%%%%%%%%%%%%