%%%%%%%%%%%%%%%%%%%%%%%%%
%%%%%%%%%%%%%%%%%%%     %
%%%%%%%%%%%%%%%%%%% %%% %
%    %     P     %  %%% %
%%%%%%%%%%%%%%%%    %%% %
%              %  % %%% %
% %% %% %% %% %% %  % % %
%                %  % % %
% %%%%%%%%%%%%%%%%%%%%% %
%%%                     %
%.....                  %
%%%%%%%%%%%%%%%%%%%%%%%%%
