%%%%%%%%%%%%%%%%%%%%%%%%%%%%%%%%%%%%%%%%%%%%%%%
%%%%%%%%%%%%%%%%%%%%%%%%%%%%%                 %
%% %%% % %%% %% % % %%%%%%% % %%%%%%%%%%%%%%% %
% % % %    P%   %     %     %   %   %% %    % %
%%% %%% % %%%%% %%%%% %%% %%% %%%%% %%%%    % %
%     % % %     % %     % %   % % % %% %    % %
%                                           % %
%%%%%%%%%%%%%%%%%%%%%%%%%%%%%%%%%%%%%%%%%%%%% %
%.                                            %
%%%%%%%%%%%%%%%%%%%%%%%%%%%%%%%%%%%%%%%%%%%%%%%