%%%%%%%%%%%%%%%%%%%%%%
%         P      %   %
%%%%%%%%%%%%%%%%     %
%              %  %  %
% %% %% %% %% %% %   %
%                %   %
%%%%%%%%%%%%%%%%%%   %
%.....               %
%%%%%%%%%%%%%%%%%%%%%%
